0 0 p 0 0 0 0 0 0 0 0 0 0 0 0 0 0 0 0 0 0 0 0 0 0 0 b 0
0 0 0 0 0 0 0 0 0 0 0 0 0 0 0 0 0 0 0 0 0 0 0 0 0 0 0 0
0 0 0 0 0 0 0 0 0 0 0 0 0 0 0 0 0 0 0 0 0 0 0 0 0 0 0 0
5 3 3 3 3 3 3 3 3 3 3 3 3 3 3 3 3 3 3 3 3 3 3 3 3 3 3 6
4 1 1 1 1 1 1 1 1 1 1 1 1 1 1 1 1 1 1 1 1 1 1 1 1 1 1 4
4 1 5 3 3 3 3 3 3 3 3 6 1 5 6 1 5 3 3 3 3 3 3 3 3 6 1 4
4 2 4 0 0 0 0 0 0 0 0 4 1 4 4 1 4 0 0 0 0 0 0 0 0 4 2 4
4 1 4 0 0 5 3 3 3 3 3 8 1 7 8 1 7 3 3 3 3 3 3 3 3 8 1 4
4 1 4 0 0 4 1 1 1 1 1 1 1 1 1 1 1 1 1 1 1 1 1 1 1 1 1 4
4 1 4 0 0 4 1 5 6 1 5 3 3 3 3 3 3 6 1 5 6 1 5 3 3 6 1 4
4 1 7 3 3 8 1 4 4 1 7 3 3 6 5 3 3 8 1 4 4 1 7 3 3 8 1 4
4 1 1 1 1 1 1 4 4 1 1 1 1 4 4 1 1 1 1 4 4 1 1 1 1 1 1 4
7 3 3 3 3 6 1 4 7 3 3 6 0 4 4 0 5 3 3 8 7 3 3 3 3 3 3 8
0 0 0 0 0 4 1 4 5 3 3 8 0 7 8 0 7 3 3 6 0 0 0 0 0 0 0 0
0 0 0 0 0 4 1 4 4 0 0 0 0 E 0 0 0 0 0 4 0 0 0 0 0 0 0 0 
0 0 0 0 0 4 1 4 4 0 5 3 3 9 9 3 3 6 0 4 0 0 0 0 0 0 0 0
3 3 3 3 3 8 1 7 8 0 4 0 0 0 0 0 0 4 0 4 5 3 3 3 3 3 3 3
0 0 2 0 0 0 1 0 0 0 4 I 0 B P 0 C 4 0 4 4 1 0 0 0 2 0 0
3 3 3 3 3 6 1 5 6 0 4 0 0 0 0 0 0 4 0 4 4 1 5 3 3 3 3 3
0 0 0 0 0 4 1 4 4 0 7 3 3 3 3 3 3 8 0 4 4 1 4 0 0 0 0 0
0 0 0 0 0 4 1 4 4 0 0 0 0 0 0 0 0 0 0 4 4 1 4 0 0 0 0 0
0 0 0 0 0 4 1 4 4 0 5 3 3 3 3 3 3 6 0 4 4 1 4 0 0 0 0 0
5 3 3 3 3 8 1 7 8 0 7 3 3 6 5 3 3 8 0 7 8 1 7 3 3 3 3 6
4 1 1 1 1 1 1 1 1 1 1 1 1 4 4 1 1 1 1 1 1 1 1 1 1 1 1 4
4 1 5 3 3 6 1 5 3 3 3 6 1 4 4 1 5 3 3 3 6 1 5 3 3 6 1 4
4 1 7 3 6 4 1 7 3 3 3 8 1 7 8 1 7 3 3 3 8 1 4 5 3 8 1 4
4 2 1 1 4 4 1 1 1 1 1 1 1 M 0 1 1 1 1 1 1 1 4 4 1 1 2 4
7 3 6 1 4 4 1 5 6 1 5 3 3 3 3 3 3 6 1 5 6 1 4 4 1 5 3 8
5 3 8 1 7 8 1 4 4 1 7 3 3 6 5 3 3 8 1 4 4 1 7 8 1 7 3 6
4 1 1 1 1 1 1 4 4 1 1 1 1 4 4 1 1 1 1 4 4 1 1 1 1 1 1 4
4 1 5 3 3 3 3 8 7 3 3 6 1 4 4 1 5 3 3 8 7 3 3 3 3 6 1 4
4 1 7 3 3 3 3 3 3 3 3 8 1 7 8 1 7 3 3 3 3 3 3 3 3 8 1 4
4 1 1 1 1 1 1 1 1 1 1 1 1 1 1 1 1 1 1 1 1 1 1 1 1 1 1 4
7 3 3 3 3 3 3 3 3 3 3 3 3 3 3 3 3 3 3 3 3 3 3 3 3 3 3 8
c 0 0 0 0 0 0 0 0 0 0 0 0 0 0 0 0 0 0 0 0 0 0 0 0 0 0 i
0 0 0 0 0 0 0 0 0 0 0 0 0 0 0 0 0 0 0 0 0 0 0 0 0 0 0 0